15
15
1
11
111111111111111
166666696666661
100000000000001
105005000500501
107007000700701
105005000500501
107007000700701
105005000500501
107007000700701
105005000500501
107007000700701
4
file\map\hallwayClass.txt
00000000000001
100000000000001
100000000000001
111111111111111