15
15
1
11
Right
111111111111111
166666696666661
100000002
prof
000001
105005000500501
107007000700701
105005000500501
107007000700701
105005000500501
107007000700701
105005000500501
107007000700701
4
file\map\hallwayClass.txt
00000000000001
10000000000002
lea
1
100000000000001
111111111111111