15
15
1
7
111111111111111
100000000000001
100000000000001
100000000000001
100000000000001
100000000000001
100000000000001
4
file\map\hallwayClass.txt
00000000000001
100000000000001
100000000000001
100000000000001
100000000000001
100000000000001
100000000000001
111111111111111