16
10
13
8
Up
1111111111111111
1666666666666661
1008000080000801
1002
pres
0000=0000=01
100000000000002
sami
1
1008000080000801
100=0000=0000=01
1000000000000001
1000000000000001
11111111111114
file\map\hallwayDrago.txt
11