16
10
13
8
1111111111111111
1666666666666661
1008000080000801
1000000000000001
1000000000000001
1008000080000801
1000000000000001
1000000000000001
1000000000000001
11111111111114
file\map\hallwayDrago.txt
11