16
10
13
8
1111111111111111
1000000000000001
1000000000000001
1000000000000001
1000005000000001
1000000000000001
1000000000000001
1000000000000001
1000000000000001
11111111111114
file\map\hallwayDrago.txt
11