9
9
7
4
Left
111111111
166666661
10000002
david
1
100000001
100000004
file\map\hallwayHome.txt
100000001
100000001
100000001
111111111