11
11
5
2
11111111111
166664
file\map\hallwayProf1.txt
66661
10000000001
10000000001
10;:000:<01
10;:000:<01
10;:000:<01
10;:000:<01
10000000001
10000000001
11111111111


