11
11
5
1
111114
file\map\hallwayProf1.txt
11111
10000000001
10000000001
10000000001
10000000001
10000000001
10000000001
10000000001
10000000001
10000000001
11111111111

